1
333222223333333333000000
333333333322200333000000
333222222222200333332330
3330033333322003330BBB20
333000003322200333000000
333333322322200333000000
333000022230302223000000
333000022221233333000000
333000000022200333000000
333000000022200333000000
333000000022200333000000
333000000022200333000000
333333333322200333333330
333000000022200333000000
